1	1	1	1	1	1	1	1	1	1	1	1	1	1	1	1	1	1	1	1	1	1	1	1	1	1	1	1	1	1	1	1	1	1	1	1	1	1	1	1	1	1	1	1	1	1	1	1	1	1	1	1	1	1	1	1	1	1	1	1	1	1	1	1	1	1	1	1	1	1	1	1
1	1	1	1	1	1	1	1	1	1	1	1	1	1	1	1	1	1	1	1	1	1	1	1	1	1	1	1	1	1	1	1	1	1	1	1	1	1	1	1	1	1	1	1	1	1	1	1	1	1	1	1	1	1	1	1	2008	1	0	1	1	1	1	1	1	1	1	0	0	0	0	1
1	0	1	108	1	0	0	0	0	0	0	0	0	0	0	0	0	0	0	0	0	1	0	0	0	0	0	0	0	0	0	0	0	0	0	0	1	0	0	0	0	0	0	0	0	0	0	0	1	0	0	0	1	0	1	1	0	1	0	1	0	0	0	0	0	0	1	0	1	1	0	1
1	0	0	0	1	0	1	1	1	1	1	1	1	1	1	1	1	1	1	1	0	1	0	1	1	1	1	1	1	1	1	1	1	1	1	1	1	1	1	1	1	1	1	1	1	1	1	0	1	0	1	0	0	0	0	0	0	0	0	0	0	1	1	1	1	0	1	0	1	1	0	1
1	0	1	0	1	0	1	1	1	1	0	1	1002	1	0	1	1	1	1003	1	0	1	0	0	0	0	0	0	0	0	0	0	0	0	0	0	0	0	0	0	0	0	0	0	0	0	1	0	1	0	1	0	1	1	1	1	1	1	2001	1	1	1	1	1	1	0	1	0	1	1	0	1
1	0	1	0	1	0	0	0	0	1	0	1	0	1	0	0	0	0	0	1	0	1	0	1	1	1	1	1	1	1	1	1	1	0	1	0	1	1	1	1	1	1	1	1	1	0	1	0	1	0	1	1006	1	1	1	1	1	1	1	1	1	1	1	1	1	0	1	0	1	0	0	1
1	0	1	0	1	1	1	1	0	1	0	1	0	1	0	1	1	1	1	1	0	1	0	1	0	0	0	0	0	0	0	0	1	0	1	0	1	0	0	0	0	108	1	0	1	0	1	0	1	0	1	1	1	1	0	0	0	0	0	0	0	0	0	0	0	0	1	0	1	1	0	1
1	0	1	0	0	0	0	0	0	1	1	1	0	1	0	0	0	0	0	1	0	1	0	1	0	1	1	1	0	1	1	1	1	0	1	0	1	0	1	0	1	1	1	0	1	0	1	0	1	0	0	0	0	1	0	1	1	1	1	1	1	1	1	1	1	1	1	0	1	1	0	1
1	0	1	1	1	1	1	1	1	1	1	0	0	1	1	1	1	1	0	1	0	1	0	1	0	1	0	1	0	1	1	2002	1	0	1	0	1	0	1	0	0	0	1	0	1	0	1	0	1	1	0	1	0	1	0	1	0	0	0	0	0	0	0	0	0	0	0	0	1	1	0	1
1	0	1	0	0	0	0	0	1	0	1	0	1	1	1	1	1	1	0	1	0	1	0	1	0	1	0	1	0	1	0	0	1	0	1	0	1	0	1	0	1	0	1	0	1	0	1	0	1	1	0	1	0	1	0	1	0	1	0	1	1	1	1	1	1	1	1	1	1	1	0	1
1	0	1	0	1	1	1	0	1	0	1	0	0	0	0	0	0	0	0	1	0	1	0	1	0	1	0	1	0	1	1003	0	1	0	1	0	1	0	1	0	1	0	1	0	1	0	1	0	1	1	0	1	0	1	0	1	0	1	0	1	1	1	1	0	0	0	0	0	1	1	0	1
1	0	1	0	1	1	1	0	1	0	1	1	1	0	1	0	1	0	1	1	0	1	0	1	0	0	0	1	0	1	0	0	1	0	1	0	1	0	1	0	1	0	1	0	1	0	1	0	1	1	0	1	0	0	0	1	0	1	0	1	1	1	1	0	1	1	1	0	0	0	0	1
1	0	1	0	1	1	1	0	1	0	1	0	1	0	1	0	1	0	1	0	0	1	0	1	1	1	1	1	0	1	1	1	1	0	1	0	1	0	1	1	1	1	1	0	1	0	1	0	1	1	1	1	0	1	0	1	0	1	0	1	1	1	1	0	1	1	1	0	1	1	0	1
1	0	1	0	1	1	1	0	1	0	1	0	1	0	1	0	1	0	1	0	0	1	0	1	0	0	0	0	0	0	0	0	0	0	1	0	0	0	0	0	0	0	0	0	1	0	1	0	1	0	0	0	0	1	0	1	0	1	0	0	0	0	0	0	0	0	1	0	1	1	0	1
1	0	1	0	1	0	1	0	1	0	1	0	1	0	1	0	1	0	1	1	0	1	0	1	1	1	1	1	1	1	0	1	1	1	1	1	1	1	1	1	1	1	1	1	1	1	1	0	1	0	1	1	1	1	0	1	0	1	1	1	1	1	1	1	1	1	1	0	1	1	0	1
1	0	1	0	1	0	1	0	1	0	1	0	1	0	1	0	1	0	0	1	0	1	0	1	1	0	0	0	0	0	0	0	0	0	0	0	0	0	0	0	0	0	0	0	0	0	0	0	1	0	1	1	1	1	0	1	0	1	0	0	0	0	1	1	1	1	1	0	1	1	0	1
1	0	1	0	1	0	1	0	1	0	1	0	1	0	1	0	1	1	0	1	0	1	0	1	1	0	1	1	1	1	1	1	1	1	1	1	1	1	1	1	1	1	1	1	1	1	1	1	1	0	1	1	1	1	0	1	0	1	1	1	1	1	1	1	1	1	1	0	1	1	0	1
1	0	1	0	1	0	0	0	1	0	1	0	1	0	1	0	2007	1	0	1	0	1	0	1	1	0	1	0	0	0	0	0	0	0	0	0	0	0	0	0	0	0	0	0	0	0	1	1	1	0	1	0	0	0	0	0	0	0	0	0	0	0	0	1	1	1	1	0	1	1	0	1
1	0	1	0	1	1	1	1	1	0	1	0	1	0	1	0	1	1	0	1	0	1	0	1	1	0	1	0	1	1	1	1	1	1	1	1	1	1	1	1	1	1	1	1	1	0	0	0	0	0	1	1	1	1	1	1	1	1	1	1	1	1	1	1	1	1	1	0	0	0	0	1
1	0	1	0	1	1	1	1	1	0	0	0	1	0	1	0	0	0	0	1	0	1	0	1	1	0	1	0	1	0	0	1	2006	0	0	0	0	0	0	0	0	0	0	0	0	0	1	1	0	1	1	1	1	1	1	1	1	1	1	1	1	1	1	1	1	1	1	0	1	1	0	1
1	0	1	0	1	1	0	1	1	1	1	0	1	0	1	1	1	1	1	1	0	1	0	1	1	0	1	0	1	1	1	1	1	1	1	1	1	1	1	1	1	1	1	1	1	1	1	1	0	1	0	0	0	0	0	0	0	0	0	0	0	0	0	0	0	0	0	0	1	1	0	1
1	0	1	0	1	1	1	1	1	1	1	0	1	0	0	0	0	0	0	0	0	1	0	1	1	0	1	0	0	0	0	0	0	0	0	0	0	0	0	0	0	0	0	0	0	0	0	1	0	1	0	1	1	1	1	1	1	1	1	1	1	1	1	0	1	1	1	0	1	1	0	1
1	0	1	0	1	1	1	1	1	1	1	0	1	1	1	1	1	1	1	1	0	1	0	1	1	0	1	1	1	1	1	1	1	1	1	1	1	1	1	1	1	1	1	1	1	1	0	1	0	1	0	1	1	1000	0	0	0	0	0	0	0	0	0	0	1	1	1	0	1	1	0	1
1	0	1	0	1	900	900	900	900	1	1	0	1	1	1	0	0	0	0	1	0	1	0	0	0	0	0	0	0	0	0	0	0	0	0	0	0	0	0	0	0	0	0	0	1	1	0	1	0	1	0	1	1	1	1	0	1	1	1	1	1	1	1	1	1	1006	0	0	1	1	0	1
1	0	1	0	1	1001	900	900	900	1	1	0	1	1	1	1	1	1	0	1	0	1	1	1	1	1	1	1	1	1	1	1	1	1	1	1	1	1	1	1	1	1	1	0	1	1	0	1	0	1	0	1	1	1	1	0	1	0	0	0	0	0	0	0	1	1	1	0	1	1	0	1
1	0	1	0	1	1	0	0	1	1	1	0	1	1	1	0	0	0	0	1	0	0	0	0	0	0	0	0	0	0	0	0	0	0	0	0	0	0	0	0	0	0	1	0	1	1	0	1	0	1	0	1	1004	0	1	0	1	0	1	1	1	1	1	0	1	1	1	0	1	1	0	1
1	0	1	0	1	1	0	0	1	1	1	0	1	1	1	1	0	1	0	1	1	1	1	1	1	1	1	0	1	1	1	1	1	1	1	1	1	0	1	1	1	1	1	0	1	1	0	1	0	1	0	1	0	0	1	0	1	0	1	108	1	1	1	0	1	1	1	0	1	1	0	1
1	0	0	0	0	0	0	0	0	0	0	0	1	1	1	1	0	1	0	1	1	0	1004	0	1	0	1	0	1	0	0	0	0	0	0	0	1	0	1	0	0	0	0	0	1	1	0	1	0	1	0	1	0	1004	1	0	1	0	1	0	1	1	1	0	1	1	1	0	0	0	0	1
1	0	1	1	1	1	1	1	1	1	1	0	1	1	1	1	0	1	0	0	0	0	0	0	1	0	1	0	1	1	1	1	1	0	1	0	1	0	1	0	1	1	1	1	1	1	0	1	0	1	0	1	0	0	1	0	1	0	1	0	1	1	1	0	1	1	1	0	1	1	0	1
1	0	0	0	0	0	0	0	0	0	1	0	0	0	0	1	0	1	1	1	0	1	1	1	1	0	1	0	1	0	0	0	0	0	1	0	1	0	1	0	1	1	1	1	1	1	0	1	0	1	0	1	1	1	1	0	1	0	1	0	1	1	1	0	1	1	1	0	1	1	0	1
1	0	1	1	1	1	1	1	1	0	1	1	1	1	0	1	0	1	0	1	0	1	0	0	0	0	1	0	1	1004	1	1	1	0	1	0	1	0	1	0	0	0	0	0	0	1	0	1	0	1	0	1	0	0	1	0	1	0	1	0	1	1	1	0	1	1	1	0	1	1	0	1
1	0	1	0	0	0	0	0	0	0	0	0	0	1	0	0	0	1	0	1	0	1	0	1	1	1	1	0	1	0	0	108	1	0	1	0	1	0	1	0	1	1	1	1	0	1	0	1	0	1	0	1	2051	2051	1	0	1	0	1	0	1	1	1	0	1	1	1	0	1	1	0	1
1	0	1	0	1	1	1	1	1	0	1	1	1	1	1	1	1	1	0	0	0	1	0	0	0	0	0	0	1	1	1	1	1	0	1	0	1	0	1	0	1	1	0	1	0	1	0	1	0	0	0	1	2051	2051	1	0	1	0	0	0	0	0	1	0	1	1	1	0	1	1	0	1
1	0	1	0	1	0	0	0	1	0	1	0	0	0	0	0	0	0	0	1	0	1	1	1	1	1	1	1	1	0	0	0	0	0	1	0	0	0	0	0	1	0	0	1	0	1	0	1	1	1	1	1	2051	2051	1	0	1	1	1	1	1	0	1	0	1	1	1	0	1	1	0	1
1	0	1	0	1	0	1	0	1	0	1	0	1	1	1	1	1	1	0	1	0	0	0	0	0	0	0	1	1	1	1	1	1	1	1	0	1	0	1	0	1	0	0	1	0	1	0	1	0	1	1	1	2051	2051	0	0	0	0	0	0	0	0	1	0	1	1	1	0	1	1	0	1
1	0	1	0	1	0	1	0	1	0	1	0	1	0	0	0	0	1	0	1	1	1	1	1	1	1	0	0	0	0	0	0	0	0	0	0	1	0	1	0	1	2003	0	1	0	1	0	1	0	1	2005	0	0	1	1	1	1	1	1	1	1	1	1	0	1	1	1	0	1	1	0	1
1	0	1	0	1	0	1	0	1	0	1	0	1	0	1	0	0	1	0	0	0	0	0	0	0	1	0	1	1	1	1	1	1	1	1	0	1	0	1	0	1	1	0	1	0	1	0	1	0	1	1	1	0	1	1	0	1	0	0	0	0	0	0	0	1	1	1	0	1	0	0	1
1	0	1	0	1	0	1	0	1	0	1	0	1	0	1	0	0	1	1	1	0	1	1	1	0	1	0	1	0	0	0	0	0	0	0	0	1	0	1	0	1	0	0	1	0	1	0	1	0	1	1	1	0	0	0	0	1	0	1	1	1	1	1	0	1	1	1	0	1	0	1	1
1	0	1	0	1	0	1	0	1	0	1	0	1	0	1	0	0	1	1	0	0	1	0	1	0	1	0	1	0	1	1	1	1	1	1	1	1	0	1	0	1	0	1	1	0	1	0	1	0	1	1	1	1	1	1	1	1	0	1	0	0	0	1	0	1	1	1	0	1	0	1	1
1	0	1	0	1	0	1	0	1	0	1	0	1	0	1	0	1	1	1	2050	2050	1	0	1	0	1	0	1	0	0	0	0	0	0	0	1006	1	0	1	0	1	0	0	1	0	1	0	1	0	1	1	0	0	0	0	0	1	0	1	0	1	0	1	0	1	1	1	0	1	0	1	1
1	0	1	0	0	0	1	0	1	0	1	0	1	0	1	0	1	0	1	2050	2050	1	1	1	0	1	0	1	0	1	1	1	1	1	1	1	1	0	1	0	1	0	1	1	0	1	0	1	0	1	1	0	1	1	1	0	1	0	1	0	1	0	1	0	1	1	1	0	1	0	1	1
1	0	1	1	1	1	1	0	1	0	0	0	0	0	1	0	1	0	1	2050	2050	1	0	1	0	1	0	1	0	1	0	0	0	0	0	0	0	0	1	0	1	0	1	1	0	1	0	1	0	1	1	0	1	0	0	0	1	0	1	0	1	0	1	0	1	1	1	0	1	0	1	1
1	0	1	0	0	0	0	0	1	0	1	0	1	0	1	0	1	0	1	2050	2050	1	0	1	0	1	0	1	0	1	0	1	1	1	1	1	1	1	1	0	1	0	0	1	0	1	0	1	0	1	1	0	1	0	1	1	1	0	1	0	1	0	1	0	1	1	1	0	1	0	1	1
1	0	1	0	1	1	1	0	1	0	1	0	1	0	1	0	1	0	1	2050	2050	1	0	1	0	1	0	1	0	1	0	1	0	0	0	0	0	0	0	0	1	1	0	1	0	1	0	1	0	1	1	0	1	0	0	0	1	0	1	0	1	0	1	0	1	1005	0	0	1	0	1	1
1	0	1	0	1	2000	1	0	1	0	1	0	1	0	1	0	1	0	1	2050	2050	1	0	1	0	1	0	1	0	1	0	1	0	1	0	1	1	1	1	0	1	1	0	1	0	1	0	1	0	1	0	0	1	1	1	1	1	0	1	0	1	0	1	0	1	0	0	0	1	0	1	1
1	0	1	0	1	0	1	0	1	0	1	0	1	0	1	0	1	0	1	2050	2050	1	0	1	0	1	0	1	0	1	0	1	0	1	0	1	1	1	1	1	1	1	0	1	0	1	0	1	0	0	0	0	0	0	0	0	0	0	1	0	1	0	1	0	1	0	1	0	1	0	1	1
1	0	1	0	1	0	1	0	1	0	1	0	1	0	1	0	1	0	1	2050	2050	1	0	1	0	1	0	1	0	1	0	1	0	1	0	1	0	0	2004	1	0	0	0	1	0	1	0	1	0	1	0	1	1	1	1	1	1	0	1	0	1	0	1	0	1	0	0	0	1	0	1	1
1	0	1	0	1	0	1	0	1	0	1	0	1	0	1	0	1	0	1	2050	2050	1	0	1	0	1	0	1	0	1	0	1	0	1	0	1	1	0	1	1	1	1	0	1	0	1	0	1	0	1	0	0	0	0	0	0	1	0	1	0	1	0	1	0	1	0	0	0	1	0	1	1
1	0	1	0	1	0	1	0	1	0	1	0	1	0	0	0	0	0	0	0	0	1	0	1	0	1	0	1	0	1	0	1	0	1	0	1	1	0	0	1006	0	1	0	1	0	1	0	1	0	1	1	1	2009	1	1	0	1	0	1	0	1	0	1	0	1	1	1	1	1	0	1	1
1	0	1	0	1	0	1	0	1	0	1	0	1	1	1	0	1	0	1	1	0	1	0	1	0	1	0	1	1	1	0	1	0	1	0	1	1	1	1	1	1	1	0	1	0	1	0	1	0	1	1	1	1	1	1	0	1	0	1	0	1	0	0	0	0	0	0	0	0	0	1	1
1	0	0	0	0	0	1	0	1	0	1	0	1	1	1	0	1	0	1	1	0	1	0	0	0	1	0	0	0	0	0	1	0	1	0	1	0	0	0	0	0	0	0	0	0	1	0	1	0	1	1	1	0	0	0	0	1	0	1	0	1	1	1	1	1	1	1	1	1	1	1	1
1	0	1	1	1	1	1	1	1	1	1	1	1	1	1	1	1	0	1	1	0	1	1	1	1	1	1	1	1	1	1	1	0	1	0	1	1	1	1	1	1	1	1	1	1	1	0	1	0	1	1	1	1	1	1	1	1	0	1	0	1	1	1	1	0	0	0	0	0	0	0	1
1	0	1	0	0	0	0	0	0	0	0	0	0	0	0	0	0	0	1	1	0	0	0	0	0	0	0	0	0	0	0	0	0	1	0	0	0	0	0	0	0	0	0	0	0	0	0	1	0	0	0	0	0	0	0	0	0	0	1	0	0	0	0	0	0	0	1	1	1	0	108	1
1	1	1	1	1	1	1	1	1	1	1	1	1	1	1	1	1	1	1	1	1	1	1	1	1	1	1	1	1	1	1	1	1	1	1	1	1	1	1	1	1	1	1	1	1	1	1	1	1	1	1	1	1	1	1	1	1	1	1	1	1	1	1	1	1	1	1	1	1	1	1	1
1	1	1	1	1	1	1	1	1	1	1	1	1	1	1	1	1	1	1	1	1	1	1	1	1	1	1	1	1	1	1	1	1	1	1	1	1	1	1	1	1	1	1	1	1	1	1	1	1	1	1	1	1	1	1	1	1	1	1	1	1	1	1	1	1	1	1	1	1	1	1	1
